XXXXXXX
XDCCDEX
XDDCDCX
XSCCDCX
XCDCDCX
XDDCDEX
XXXXXXX