XXXXXX
X0XDXX
XDDDDX
X0XDXX
XXXXXX