XXXXXXX
XDCCDEX
XDDCDCX
XCCCDCX
XCDCDCX
XDDCDCX
XXXXXXX