XXXXXXX
XDCCDCX
XDDCDCX
XSDCDCX
XCDCDCX
XDDCDCX
XXXXXXX