XXXXXXX
XDCCDCX
XDDCDCX
XSCCDCX
XCDCDCX
XDDCDCX
XXXXXXX