XXXXXX
XDXDXX
XDDDDX
XSXDXX
XXXXXX