XXXXXXX
XDCCDEX
XDDCDCX
XSCCDCX
XCDCDCX
XDDCDCX
XXXXXXX